/nucleus/projects/cancer_cell_lines/WGS/Contino_EAC_cell_lines/AA_outputs/OACP4-C/OACP4-C_classification/OACP4-C_classification_bed_files/OACP4-C_amplicon10_ecDNA_1_intervals.bed	/nucleus/projects/cancer_cell_lines/WGS/Contino_EAC_cell_lines/AA_outputs/OACP4-C/OACP4-C_AA_results/OACP4-C_amplicon10_graph.txt
/nucleus/projects/cancer_cell_lines/WGS/Contino_EAC_cell_lines/AA_outputs/OACP4-C/OACP4-C_classification/OACP4-C_classification_bed_files/OACP4-C_amplicon11_Complex non-cyclic_1_intervals.bed	/nucleus/projects/cancer_cell_lines/WGS/Contino_EAC_cell_lines/AA_outputs/OACP4-C/OACP4-C_AA_results/OACP4-C_amplicon11_graph.txt
/nucleus/projects/cancer_cell_lines/WGS/Contino_EAC_cell_lines/AA_outputs/OACP4-C/OACP4-C_classification/OACP4-C_classification_bed_files/OACP4-C_amplicon12_ecDNA_1_intervals.bed	/nucleus/projects/cancer_cell_lines/WGS/Contino_EAC_cell_lines/AA_outputs/OACP4-C/OACP4-C_AA_results/OACP4-C_amplicon12_graph.txt
/nucleus/projects/cancer_cell_lines/WGS/Contino_EAC_cell_lines/AA_outputs/OACP4-C/OACP4-C_classification/OACP4-C_classification_bed_files/OACP4-C_amplicon13_ecDNA_1_intervals.bed	/nucleus/projects/cancer_cell_lines/WGS/Contino_EAC_cell_lines/AA_outputs/OACP4-C/OACP4-C_AA_results/OACP4-C_amplicon13_graph.txt
/nucleus/projects/cancer_cell_lines/WGS/Contino_EAC_cell_lines/AA_outputs/OACP4-C/OACP4-C_classification/OACP4-C_classification_bed_files/OACP4-C_amplicon14_ecDNA_1_intervals.bed	/nucleus/projects/cancer_cell_lines/WGS/Contino_EAC_cell_lines/AA_outputs/OACP4-C/OACP4-C_AA_results/OACP4-C_amplicon14_graph.txt
/nucleus/projects/cancer_cell_lines/WGS/Contino_EAC_cell_lines/AA_outputs/OACP4-C/OACP4-C_classification/OACP4-C_classification_bed_files/OACP4-C_amplicon15_Complex non-cyclic_1_intervals.bed	/nucleus/projects/cancer_cell_lines/WGS/Contino_EAC_cell_lines/AA_outputs/OACP4-C/OACP4-C_AA_results/OACP4-C_amplicon15_graph.txt
/nucleus/projects/cancer_cell_lines/WGS/Contino_EAC_cell_lines/AA_outputs/OACP4-C/OACP4-C_classification/OACP4-C_classification_bed_files/OACP4-C_amplicon16_Linear amplification_1_intervals.bed	/nucleus/projects/cancer_cell_lines/WGS/Contino_EAC_cell_lines/AA_outputs/OACP4-C/OACP4-C_AA_results/OACP4-C_amplicon16_graph.txt
/nucleus/projects/cancer_cell_lines/WGS/Contino_EAC_cell_lines/AA_outputs/OACP4-C/OACP4-C_classification/OACP4-C_classification_bed_files/OACP4-C_amplicon17_ecDNA_1_intervals.bed	/nucleus/projects/cancer_cell_lines/WGS/Contino_EAC_cell_lines/AA_outputs/OACP4-C/OACP4-C_AA_results/OACP4-C_amplicon17_graph.txt
/nucleus/projects/cancer_cell_lines/WGS/Contino_EAC_cell_lines/AA_outputs/OACP4-C/OACP4-C_classification/OACP4-C_classification_bed_files/OACP4-C_amplicon18_ecDNA_1_intervals.bed	/nucleus/projects/cancer_cell_lines/WGS/Contino_EAC_cell_lines/AA_outputs/OACP4-C/OACP4-C_AA_results/OACP4-C_amplicon18_graph.txt
/nucleus/projects/cancer_cell_lines/WGS/Contino_EAC_cell_lines/AA_outputs/OACP4-C/OACP4-C_classification/OACP4-C_classification_bed_files/OACP4-C_amplicon19_Linear amplification_1_intervals.bed	/nucleus/projects/cancer_cell_lines/WGS/Contino_EAC_cell_lines/AA_outputs/OACP4-C/OACP4-C_AA_results/OACP4-C_amplicon19_graph.txt
/nucleus/projects/cancer_cell_lines/WGS/Contino_EAC_cell_lines/AA_outputs/OACP4-C/OACP4-C_classification/OACP4-C_classification_bed_files/OACP4-C_amplicon1_ecDNA_1_intervals.bed	/nucleus/projects/cancer_cell_lines/WGS/Contino_EAC_cell_lines/AA_outputs/OACP4-C/OACP4-C_AA_results/OACP4-C_amplicon1_graph.txt
/nucleus/projects/cancer_cell_lines/WGS/Contino_EAC_cell_lines/AA_outputs/OACP4-C/OACP4-C_classification/OACP4-C_classification_bed_files/OACP4-C_amplicon20_ecDNA_1_intervals.bed	/nucleus/projects/cancer_cell_lines/WGS/Contino_EAC_cell_lines/AA_outputs/OACP4-C/OACP4-C_AA_results/OACP4-C_amplicon20_graph.txt
/nucleus/projects/cancer_cell_lines/WGS/Contino_EAC_cell_lines/AA_outputs/OACP4-C/OACP4-C_classification/OACP4-C_classification_bed_files/OACP4-C_amplicon21_Linear amplification_1_intervals.bed	/nucleus/projects/cancer_cell_lines/WGS/Contino_EAC_cell_lines/AA_outputs/OACP4-C/OACP4-C_AA_results/OACP4-C_amplicon21_graph.txt
/nucleus/projects/cancer_cell_lines/WGS/Contino_EAC_cell_lines/AA_outputs/OACP4-C/OACP4-C_classification/OACP4-C_classification_bed_files/OACP4-C_amplicon22_Linear amplification_1_intervals.bed	/nucleus/projects/cancer_cell_lines/WGS/Contino_EAC_cell_lines/AA_outputs/OACP4-C/OACP4-C_AA_results/OACP4-C_amplicon22_graph.txt
/nucleus/projects/cancer_cell_lines/WGS/Contino_EAC_cell_lines/AA_outputs/OACP4-C/OACP4-C_classification/OACP4-C_classification_bed_files/OACP4-C_amplicon23_ecDNA_1_intervals.bed	/nucleus/projects/cancer_cell_lines/WGS/Contino_EAC_cell_lines/AA_outputs/OACP4-C/OACP4-C_AA_results/OACP4-C_amplicon23_graph.txt
/nucleus/projects/cancer_cell_lines/WGS/Contino_EAC_cell_lines/AA_outputs/OACP4-C/OACP4-C_classification/OACP4-C_classification_bed_files/OACP4-C_amplicon24_ecDNA_1_intervals.bed	/nucleus/projects/cancer_cell_lines/WGS/Contino_EAC_cell_lines/AA_outputs/OACP4-C/OACP4-C_AA_results/OACP4-C_amplicon24_graph.txt
/nucleus/projects/cancer_cell_lines/WGS/Contino_EAC_cell_lines/AA_outputs/OACP4-C/OACP4-C_classification/OACP4-C_classification_bed_files/OACP4-C_amplicon25_Linear amplification_1_intervals.bed	/nucleus/projects/cancer_cell_lines/WGS/Contino_EAC_cell_lines/AA_outputs/OACP4-C/OACP4-C_AA_results/OACP4-C_amplicon25_graph.txt
/nucleus/projects/cancer_cell_lines/WGS/Contino_EAC_cell_lines/AA_outputs/OACP4-C/OACP4-C_classification/OACP4-C_classification_bed_files/OACP4-C_amplicon26_ecDNA_1_intervals.bed	/nucleus/projects/cancer_cell_lines/WGS/Contino_EAC_cell_lines/AA_outputs/OACP4-C/OACP4-C_AA_results/OACP4-C_amplicon26_graph.txt
/nucleus/projects/cancer_cell_lines/WGS/Contino_EAC_cell_lines/AA_outputs/OACP4-C/OACP4-C_classification/OACP4-C_classification_bed_files/OACP4-C_amplicon27_ecDNA_1_intervals.bed	/nucleus/projects/cancer_cell_lines/WGS/Contino_EAC_cell_lines/AA_outputs/OACP4-C/OACP4-C_AA_results/OACP4-C_amplicon27_graph.txt
/nucleus/projects/cancer_cell_lines/WGS/Contino_EAC_cell_lines/AA_outputs/OACP4-C/OACP4-C_classification/OACP4-C_classification_bed_files/OACP4-C_amplicon2_ecDNA_1_intervals.bed	/nucleus/projects/cancer_cell_lines/WGS/Contino_EAC_cell_lines/AA_outputs/OACP4-C/OACP4-C_AA_results/OACP4-C_amplicon2_graph.txt
/nucleus/projects/cancer_cell_lines/WGS/Contino_EAC_cell_lines/AA_outputs/OACP4-C/OACP4-C_classification/OACP4-C_classification_bed_files/OACP4-C_amplicon3_ecDNA_1_intervals.bed	/nucleus/projects/cancer_cell_lines/WGS/Contino_EAC_cell_lines/AA_outputs/OACP4-C/OACP4-C_AA_results/OACP4-C_amplicon3_graph.txt
/nucleus/projects/cancer_cell_lines/WGS/Contino_EAC_cell_lines/AA_outputs/OACP4-C/OACP4-C_classification/OACP4-C_classification_bed_files/OACP4-C_amplicon4_ecDNA_1_intervals.bed	/nucleus/projects/cancer_cell_lines/WGS/Contino_EAC_cell_lines/AA_outputs/OACP4-C/OACP4-C_AA_results/OACP4-C_amplicon4_graph.txt
/nucleus/projects/cancer_cell_lines/WGS/Contino_EAC_cell_lines/AA_outputs/OACP4-C/OACP4-C_classification/OACP4-C_classification_bed_files/OACP4-C_amplicon5_ecDNA_1_intervals.bed	/nucleus/projects/cancer_cell_lines/WGS/Contino_EAC_cell_lines/AA_outputs/OACP4-C/OACP4-C_AA_results/OACP4-C_amplicon5_graph.txt
/nucleus/projects/cancer_cell_lines/WGS/Contino_EAC_cell_lines/AA_outputs/OACP4-C/OACP4-C_classification/OACP4-C_classification_bed_files/OACP4-C_amplicon6_Linear amplification_1_intervals.bed	/nucleus/projects/cancer_cell_lines/WGS/Contino_EAC_cell_lines/AA_outputs/OACP4-C/OACP4-C_AA_results/OACP4-C_amplicon6_graph.txt
/nucleus/projects/cancer_cell_lines/WGS/Contino_EAC_cell_lines/AA_outputs/OACP4-C/OACP4-C_classification/OACP4-C_classification_bed_files/OACP4-C_amplicon7_ecDNA_1_intervals.bed	/nucleus/projects/cancer_cell_lines/WGS/Contino_EAC_cell_lines/AA_outputs/OACP4-C/OACP4-C_AA_results/OACP4-C_amplicon7_graph.txt
/nucleus/projects/cancer_cell_lines/WGS/Contino_EAC_cell_lines/AA_outputs/OACP4-C/OACP4-C_classification/OACP4-C_classification_bed_files/OACP4-C_amplicon8_ecDNA_1_intervals.bed	/nucleus/projects/cancer_cell_lines/WGS/Contino_EAC_cell_lines/AA_outputs/OACP4-C/OACP4-C_AA_results/OACP4-C_amplicon8_graph.txt
/nucleus/projects/cancer_cell_lines/WGS/Contino_EAC_cell_lines/AA_outputs/OACP4-C/OACP4-C_classification/OACP4-C_classification_bed_files/OACP4-C_amplicon9_ecDNA_1_intervals.bed	/nucleus/projects/cancer_cell_lines/WGS/Contino_EAC_cell_lines/AA_outputs/OACP4-C/OACP4-C_AA_results/OACP4-C_amplicon9_graph.txt
